NO ./assets/textures/north.png
SO ./assets/textures/south.png
WE ./assets/textures/west.png
EA ./assets/textures/east.png

F 220,100,0
C 225,30,0

111111111111111111111
100000000000000000001
100000000000000000001
100001111011110000001
100001000010000000001
100001000010000000001
1000010000100001N0001
100001000010000000001
100001000010000000001
100001111011110000001
100000000000000000001
100000000000000000001
111111111111111111111
